########################################
#...... ..+.X .....X.X....... ....X....#
#.XSX...... .........X+..X.... ..... ..#
#.......... ..X.....X.X..X........X....#
#X.XX.........X......X..X....X...X.....#
#X. X......... X..X........X......X.XX.#
#... ..X........X.....X. X........X.XX.#
###############################...X..X.#
#. ...X..+. ..X.X..........+.X+...... .#
#..+.....X..... ........XX X..X....X...#
#...X..X.X..............X .X..X........#
#.X.....X........XXX.......X.. .+....X.#
#.+.. ..X.  .....X.X+..+....X...X..+. .#
#. X..............X X..X........+.....X#
#........###############################
# X.........X...+....X.....X...X.......#
# X......... X..X........X......X.XX..E#
#. ..X........X.....X.  ....+...X.XX...#
#....X+..X........X......X.X+......X...#
#... ..X. ..X.XX.........X.X+...... ..X#
#.+.... ..... ......... .X..X....X...X.#
########################################
