###################
#S........+.......#
#+....+.........+##
#...+........+.#.E#
###################
