##################
#S  X #          #
#   + #.X..XX....#
#   X #.+..++....#
#   + #    +     #
#     #   XX     #
#     .   +.    E#
##################
