####################
#S#          XXXXX #
# #    XX    .XXX. #
# #   .XX.    .X.  #
# #    +.      +   #
# ##   XX          #
#      +X.        E#
####################
