##############
#XXXX#       #
#XXX+#  +    #
#X..S#  X##  #
#+     +X+#  #
#    #X#X#   #
#   +E....   #
#   #++      #
##############
